108,106,108,91,108,90,108,94
101,98,101,100,101,99,101,103
0,0,0,0,0,0,0,103
0,0,136,137,137,138,0,103
0,0,150,151,151,152,0,103
0,0,0,0,0,0,0,103
0,0,120,110,112,112,112,111
147,149,128,116,118,118,118,117